11111111111111111111111111111111
10000000010001111100000C0C0C0C01
111110001110001111000C0C00C01111
1111000011100C0C01110C0C0C000011
1C11000001100C010C0C1111C0000001
1P000100001C1C111000010000000001
10000100001C1C111000010000000001
10000100001C1C111000010000000001
10000100001C1C111000010000000001
10000100001C1C111000010000000001
10000100001C1C111000010000000001
10000100001C1C111000010000000001
10000100001C1C111000010000000001
10000100001C1C111000010000000001
10000100001C1C111000010000000001
10000100001C1C111000010000000001
10000100001C1C111000010000000001
10000100001C1C111000010000000001
10000100001C1C111000010000000001
10000100001C1C111000010000000001
10000100001C1C111000010000000001
10000100001C1C111000010000000001
10000100001C1C111000010000000001
10000100001C1C111000010000000001
10000100001C1C111000010000001111
10000100001C1C111000010000001E01
10000100001C1C111000010000000011
10000100001C1C111000010000000001
10000100001C1C111000010000000001
10000100001C1C111000010000000001
10000100001C1C111000010000000001
10000100001C1C111000010000000001
10000100001C1C111000010000000001
10000100001C1C111000010000000001
10000100001C1C111000010000000001
10000100001C1C111000010000000001
10000100001C1C111000010000000001
10000100001C1C111000010000000001
10000100001C1C111000010000000001
10000100001C1C111000010000000001
10000100001C1C111000010000000001
10000100001C1C111000010000000001
10000100001C1C111000010000000001
10000100001C1C111000010000000001
10000100001C1C111000010000000001
10000100001C1C111000010000000001
10000000000010000C00C0C0C0000001
11111111111111111111111111111111
