11111111111111111111111111111111
1E00000001000111110000XC0C0C0CX1
1111100011100X1111000C0C00C01111
1111000011100C0C01110C0C0CX00011
1C110X0001100C010C0C1111C0000001
10000100001C1C11100X010000X00001
1P000000000010000C00C0C0C0000001
11111111111111111111111111111111
