111111111111111111111111111111111111111111111
1E00000000CC01000C00010000CC0000X00000CC000X1
10111C0X00010001000C000010000X0000100001000C1
1100X000C00010000CC1000X0001000CC000X00CC1001
100100C00C000001000X000100X000C000111X00000C1
1X00001000CC0000X001000CCC0001000C000001000C1
11CC000010001000100X000CX001000010C00C0001001
10111C0X00010001000C000010000X0000100001000C1
100000P00010000C000C000X00000C0X00010000C1001
111111111111111111111111111111111111111111111
