111111111111111111111111111111
1P011111C011C001000C0100001111
110000000001110100100001100011
110111011C000100000011X1C01011
11X0000000X0C00010111001100XC1
1C1X1101111100X0100000101X1111
100000X000C0001101110C0001C001
111001111111000000111110111001
10001100C0000001X0C00000000X01
110100010111110001011110100101
11010111010100X00000000011C1C1
11010000110101111000110X100111
1C0000001001110000111011100C11
11X1011X0000C000101C00001X1111
1C0101011111110110110111101001
111101000100010C000100C1000001
100001000011011110010111011X01
1001100100C100000101X00001C011
1010100001011011000C1111111111
1XC00XC0X100C01C00010C00000011
1110011101110001X0011011110001
1X10111C00100X0110X1101C1CX001
101X00110110010011001000111101
100010XC01E1111000000011X1X111
10C01101110000C01X100X000000C1
111111111111111111111111111111
