111111111111111111111
10000000000000000PE11
10000000CC00000000001
111111111111111111111
